You and your best friend, Jessica, are standing outside the FUNHAUS, an abandoned funhouse located on your local abandoned fairgrounds. She finally talked you into breaking in with her and checking it out. Time to have some fun... 

You can view the commands possible in this game at any time by typing "commands list".

FUNHAUS
An Interactive Fiction by Keely Thompson
Release 1 / Serial number 170221 / Inform 7 build 6M62 (I6/v6.33 lib 6/12N) SD

The Fairgrounds
It's dark out, and all you can see is the faint outline of a red door to the north with a rickety old sign on top of it. It says FUNHAUS.

You can see Lock here.

>break lock with pliers
You break the lock on the door to the FUNHAUS.

>n
The Hallway
A black, ominous hallway. A faded pink door is to the west and a faded blue door is to the east.

A flash of white face paint and big red nose grab Jessica from your side. Before you know it they're gone, and all you can hear is the clown cackling and Jessica screaming as he takes her farther and farther into the house. You're all alone now. You have to find her and escape as soon as you can.

>down
You can't go that way.

>up
You can't go that way.

>e
(first opening Bluedoor)

The Mirrors
You walk into the room and the walls are lined with funky, light-bending mirrors. Obviously, they haven't seen the light in years. They're completely covered in dust and grime. You can see an exit here to the north.

>n
The Arcade
The walls are dingy and old. There's a ping pong table in the northeast corner, some sort of Gorilla Game in the southeast corner, and a Whac-a-Mole game on the west wall.

>take wrench
Taken.

>fix whacamole with wrench
The Whac-a-Mole machine whirs to life and goes crazy! The moles are popping up and down out of their little holes. Finally, the whole machine slides to the right revealing an exit to the west.

>w
The Rustic Bedroom
You walk into a bedroom that seems completely out of place in the FUNHAUS. It has red walls and a large bed with a rich brown colored oak headboard. There's a brown oak table by the bed with a vase on it and a big tapestry-like rug in the middle of the room. You can see an exit here to the west.

>move rug
You move just a corner of the rug up and discover that the floor underneath it is a much darker shade of wood than anywhere else in the room. You move the rug completely out of the way revealing a trapdoor!

>down
The Basement
A dark room with cement walls and floors. There's hardly any furniture in here except for a shelf on the west wall.

"Oh my god, you found me! Help!" exclaims Jess. 
 
 (To talk to Jess, simply type "Talk to Jess".)

After you jump down through the trapdoor, you see Jess in the corner of the dark room tied up! The clown doesn't seem to be around right now, hurry!

>s
The Secret Passageway

>up
The Fairgrounds
I HATE ETHAN.

>down
There's no way to go down here.

>n
The Hallway
A black, ominous hallway. A faded pink door is to the west and a faded blue door is to the east.

A flash of white face paint and big red nose grab Jessica from your side. Before you know it they're gone, and all you can hear is the clown cackling and Jessica screaming as he takes her farther and farther into the house. You're all alone now. You have to find her and escape as soon as you can.

>e
The Mirrors
You walk into the room and the walls are lined with funky, light-bending mirrors. Obviously, they haven't seen the light in years. They're completely covered in dust and grime. You can see an exit here to the north.

>n
The Arcade
The walls are dingy and old. There's a ping pong table in the northeast corner, some sort of Gorilla Game in the southeast corner, and a Whac-a-Mole game on the west wall.

>w
The Rustic Bedroom
You walk into a bedroom that seems completely out of place in the FUNHAUS. It has red walls and a large bed with a rich brown colored oak headboard. There's a brown oak table by the bed with a vase on it and a big tapestry-like rug in the middle of the room. You can see an exit here to the west.

>down
The Basement
A dark room with cement walls and floors. There's hardly any furniture in here except for a shelf on the west wall.

"Oh my god, you found me! Help!" exclaims Jess. 
 
 (To talk to Jess, simply type "Talk to Jess".)

After you jump down through the trapdoor, you see Jess in the corner of the dark room tied up! The clown doesn't seem to be around right now, hurry!

>x jess
She looks pretty much the same as she did before you guys set out on your adventure, just a lot more shaken up and terrified.

* * *

>n
The Hallway
A black, ominous hallway. A faded pink door is to the west and a faded blue door is to the east.

A flash of white face paint and big red nose grab Jessica from your side. Before you know it they're gone, and all you can hear is the clown cackling and Jessica screaming as he takes her farther and farther into the house. You're all alone now. You have to find her and escape as soon as you can.

>e
(first opening Blue door)

The Mirrors
You walk into the room and the walls are lined with funky, light-bending mirrors. Obviously, they haven't seen the light in years. They're completely covered in dust and grime. You can see an exit here to the north.

>n
The Arcade
The walls are dingy and old. There's a ping pong table in the northeast corner, some sort of Gorilla Game in the southeast corner, and a Whac-a-Mole game on the west wall.

>x table
An old ping pong table. The actual table part is an off-white color, aged from the years of neglect. There's the normal stuff a ping pong table has, two paddles, a ball, and one of those ball holder things.

>x ball holder
A built in holder for ping pong balls. Looks like there's Something Shiny in here...

>x something shiny
A typical wrench used for fixing things.

>take wrench
Taken.

>x abll hofler
You can't see any such thing.

>x ball holder
A built in holder for ping pong balls.

>x gorilla game
It's some sort of pinball game where you have to get the banana to the gorilla. Interesting.

>give banana to gorilla
You play the game and succeed in giving the banana to the gorilla, resulting in a lot of pings and whirs and automated gorilla noises emitting from the machine, but otherwise fruitless. Haha.

* * *

>e
(first opening Blue door)

The Mirrors
You walk into the room and the walls are lined with funky, light-bending mirrors. Obviously, they haven't seen the light in years. They're completely covered in dust and grime. You can see an exit here to the north.

>w
The door slammed shut when you walked in and is locked now. You hear a cackle on the other side. Looks like you're not so alone.

>x dust
You can't see any such thing.

>n
The Arcade
The walls are dingy and old. There's a ping pong table in the northeast corner, some sort of Gorilla Game in the southeast corner, and a Whac-a-Mole game on the west wall.

>x ping pong table
An old ping pong table. The actual table part is an off-white color, aged from the years of neglect. There's the normal stuff a ping pong table has, two paddles, a ball, and one of those ball holder things.

>take paddles
Taken.

>take ball
Taken.

>take ball holder thing
I only understood you as far as wanting to take Ballholder.

>take ballholder
That's hardly portable.

>x ballholder
A built in holder for ping pong balls. Looks like there's Something Shiny in here...

>x something shiny
A typical wrench used for fixing things.

>x wrench
A typical wrench used for fixing things.

>take wrench
Taken.

>l
The Arcade
The walls are dingy and old. There's a ping pong table in the northeast corner, some sort of Gorilla Game in the southeast corner, and a Whac-a-Mole game on the west wall.

>x gorilla game
It's some sort of pinball game where you have to get the banana to the gorilla. Interesting.

>x banana
The gorilla wants it, I guess.

>x gorilla
He wants his banana.

>take banana
That's hardly portable.

>x whac-a-mole
An old Whac-a-Mole game. It seems to be placed in an odd area, covering a part of the wall. It looks like it's broken and missing a few parts. It must need to be fixed.

>fix whac-a-mole
What do you want to fix Whacamole with?

>wrench
The Whac-a-Mole machine whirs to life and goes crazy! The moles are popping up and down out of their little holes. Finally, the whole machine slides to the right revealing an exit to the west.

>w
The Rustic Bedroom
You walk into a bedroom that seems completely out of place in the FUNHAUS. It has red walls and a large bed with a rich brown colored oak headboard. There's a brown oak table by the bed with a vase on it and a big tapestry-like rug in the middle of the room. You can see an exit here to the west.

* * *

>n
The Hallway
A black, ominous hallway. A faded pink door is to the west and a faded blue door is to the east.

A flash of white face paint and big red nose grab Jessica from your side. Before you know it they're gone, and all you can hear is the clown cackling and Jessica screaming as he takes her farther and farther into the house. You're all alone now. You have to find her and escape as soon as you can.

>s
The door slammed behind you with a crash when you walked in. There's no way out here.

>e
(first opening Bluedoor)

The Mirrors
You walk into the room and the walls are lined with funky, light-bending mirrors. Obviously, they haven't seen the light in years. They're completely covered in dust and grime. You can see an exit here to the north.

* * *

>n
The Arcade
The walls are dingy and old. There's a ping pong table in the northeast corner, some sort of Gorilla Game in the southeast corner, and a Whac-a-Mole game on the west wall.

>x gorilla game
It's some sort of pinball game where you have to get the banana to the gorilla. Interesting.

>x ping pong table
An old ping pong table. The actual table part is an off-white color, aged from the years of neglect. There's the normal stuff a ping pong table has, two paddles, a ball, and one of those ball holder things.

>x ball holder
A built in holder for ping pong balls. Looks like there's something shiny in here...

* * *

>x ballholder
A built in holder for ping pong balls.

>take wrench
You already have that.

>i
You are carrying:
  Wrench
  Pliers
  Pepper spray

>fix whacamole
What do you want to fix Whacamole with?

>pliers
That's hardly the right tool to fix this with.

>fix whacamole with wrench
The Whac-a-Mole machine whirs to life and goes crazy! The moles are popping up and down out of their little holes. Finally, the whole machine slides to the right revealing an exit to the west.

* * *

>move rug
You move just a corner of the rug up and discover that the floor underneath it is a much darker shade of wood than anywhere else in the room. You move the rug completely out of the way revealing a trapdoor!

>down
The Basement

>s
You can't go that way.

* * *

>n
The Hallway
A black, ominous hallway. A faded pink door is to the west and a faded blue door is to the east.

A flash of white face paint and big red nose grab Jessica from your side. Before you know it they're gone, and all you can hear is the clown cackling and Jessica screaming as he takes her farther and farther into the house. You're all alone now. You have to find her and escape as soon as you can.

>w
(first opening Pinkdoor)

The Ball Pit
You fall off the edge of the doorway into a pit of plastic colored balls. The walls are completely bare except for four Colored Indentations with a big button next to them.

>press button
Doesn't seem to do anything yet.

>put red ball in red indentation
(first taking Red ball)
You put Red ball into Red indentation.

>press button
Doesn't seem to do anything yet.

>put yellow ball in yellow indentation
(first taking Yellow ball)
You put Yellow ball into Yellow indentation.

>press button
Doesn't seem to do anything yet.

>put green ball in green indentation
(first taking Green ball)
You put Green ball into Green indentation.

>put blue ball in blue indentation
(first taking Blue ball)
You put Blue ball into Blue indentation.

>press button
A big rumbling noise erupts around you. You stand in awe as the wall starts to crack. A large rectangular piece of it breaks off and falls into the room, and you barely move out of the way in time. It's a doorway to another room to the north.

>n
The Creepy Paintings

* * *

>press button
Doesn't seem to do anything yet.

* * *

>press button
A big rumbling noise erupts around you. You stand in awe as the wall starts to crack. A large rectangular piece of it breaks off and falls into the room, and you barely move out of the way in time. It's a doorway to another room to the north.

>n
The Creepy Paintings
The room's walls are lined with dozens of creepy, nerve-racking paintings. There are ones of clowns, dolls, fake Mona Lisa, and even a ghastly girl standing in a dark forest. Wait, the Ghastly Girl seems to be moving! You can see an exit here to the east.

"Hey little one, why don't you come over and talk to me?" says Ghastly Girl.
 
 (To talk to Ghastly Girl, simply type "Talk to Ghastly Girl.")

>e
The Rustic Bedroom
You walk into a bedroom that seems completely out of place in the FUNHAUS. It has red walls and a large bed with a rich brown colored oak headboard. There's a brown oak table by the bed with a vase on it and a big tapestry-like rug in the middle of the room. You can see an exit here to the west.

>move rug
You move just a corner of the rug up and discover that the floor underneath it is a much darker shade of wood than anywhere else in the room. You move the rug completely out of the way revealing a trapdoor!

>down
The Basement
A dark room with cement walls and floors. There's hardly any furniture in here except for a shelf on the west wall. There's an exit to the south.

"Oh my god, you found me! Help!" exclaims Jess. 
 
 (To talk to Jess, simply type "Talk to Jess".)

After you jump down through the trapdoor, you see Jess in the corner of the dark room tied up! The clown doesn't seem to be around right now, hurry!

>talk to jess
 "Jess! Are you okay?" you ask. 

 "I'm okay, we have to  get out of here! The clown left, but he'll be back soon..." she replies with fear shaking her voice. (To continue talking to Jess, simply type "Talk to Jess" OR g.)

>g
 "Okay, but you're tied up!" you exclaim. 

 "Yeah, I guess you  have to find something to break the rope," she says.

>g
 "Okay, but you're tied up!" you exclaim. 

 "Yeah, I guess you  have to find something to break the rope," she says.

>break rope with knife
You cut through the rope binding her wrists with the knife. 

 To talk to Jess, simply type "Talk to Jess".

>talk to jess
"Oh, finally! My wrists feel so much better now, let's get out of here!" Jess exclaims.

>s
The Secret Passageway
A barren passageway with a trapdoor on the ceiling leading to the outside world.

You run into the Secret Passageway and are met with a cackle and the white-faced, red-nosed clown that has been tormenting you all night! He's blocking the only way out and up back to freedom!

* * *

>press button
A big rumbling noise erupts around you. You stand in awe as the wall starts to crack. A large rectangular piece of it breaks off and falls into the room, and you barely move out of the way in time. It's a doorway to another room to the north.

>undo
The Ball Pit
[Previous turn undone.]

>undo
The Ball Pit
[Previous turn undone.]

>press button
Doesn't seem to do anything yet.

* * *

>w
(first opening Pinkdoor)

The Ball Pit
You fall off the edge of the doorway into a pit of plastic colored balls. The walls are completely bare except for four Colored Indentations with a big button next to them.

>take red ball
Taken.

>put red ball in red indentation
You put Red ball into Red indentation.

>put red ball in red indentation
(first taking Red ball)
You put Red ball into Red indentation.

>put red ball in red indentaiton
You can't see any such thing.

>put red ball in red indentation
(first taking Red ball)
You put Red ball into Red indentation.

>insert red ball into red indentation
(first taking Red ball)
You put Red ball into Red indentation.

>take green ball
Taken.

>take blue ball
Taken.

>take yellow ball
Taken.

>put green ball in green indentation
You put Green ball into Green indentation.

* * *

>put blue ball in blue indentation
You put Blue ball into Blue indentation.

>put yellow ball in yellow indentation
You put Yellow ball into Yellow indentation.

>press button
A big rumbling noise erupts around you. You stand in awe as the wall starts to crack. A large rectangular piece of it breaks off and falls into the room, and you barely move out of the way in time. It's a doorway to another room to the north.

* * *

>w
(first opening Pinkdoor)

The Ball Pit
You fall off the edge of the doorway into a pit of plastic colored balls. The walls are completely bare except for four Colored Indentations with a big button next to them.

>x plastic colored balls
You can't see any such thing.

>x colored indentations
There are four spherical indentations on the wall. A red indentation, a blue indentation, a yellow indentation, and a green indentation.

>commands list
This is a list of commands available in the game. Any other action does not exist. Available shortcuts for commands are in parenthesis. 

Commands: North (n), East (e), South (s), West (w), up, down, Examine (x), Look (l), Inventory (i), 
Break ____ with ____ , Take ____ , Insert ____ into____, Press ____, Talk to ____, Fix____ with ____ , Pepperspray ____.

>insert balls into indentations
Which do you mean, Indentations, Red indentation, Blue indentation, Yellow indentation or Green indentation?

>red indentations
(first taking Balls)
Which ball do you mean dummy? You can't take all of them at once. Jeez, you have to be smarter than this if you want to make it out alive.

>take red ball
Taken.

>insert read ball into indentations
You can't see any such thing.

>insert red ball into indentations
Which do you mean, Indentations, Red indentation, Blue indentation, Yellow indentation or Green indentation?

>red indentation
You put Red ball into Red indentation.

>insert blue ball into blue indentation
(first taking Blue ball)
You put Blue ball into Blue indentation.

>insert yellow ball into yellow indentation
(first taking Yellow ball)
You put Yellow ball into Yellow indentation.

>insert green ball into green indentations
(first taking Green ball)
You put Green ball into Green indentation.

>press button
A big rumbling noise erupts around you. You stand in awe as the wall starts to crack. A large rectangular piece of it breaks off and falls into the room, and you barely move out of the way in time. It's a doorway to another room to the north.

* * *

>n
The Creepy Paintings
The room's walls are lined with dozens of creepy, nerve-racking paintings. There are ones of clowns, dolls, fake Mona Lisa, and even a ghastly girl standing in a dark forest. Wait, the Ghastly Girl seems to be moving! You can see an exit here to the east.

"Hey little one, why don't you come over and talk to me?" says Ghastly Girl.
 
 (To talk to Ghastly Girl, simply type "Talk to Ghastly Girl.")

>x painting
You can't see any such thing.

>x ghastly girl
Her face is shrouded by her black, stringy hair. She wears a simple but old-fashioned black dress, and she stands in the middle of a dark forest where nothing seems to grow. Who was the madman who thought to paint this one?!

>take black dress
You can't see any such thing.

>talk to ghastly girl
 "Hey," you say reluctantly. 

 "Hi there, you're new. We don't normally get a lot of visitors around here," replies Ghastly Girl. (To continue talking to Ghastly Girl, simply type "Talk to Ghastly Girl OR g").

>g
 "Yeah, well I'm not surprised about that part," you say with a sigh, looking around the dilapidated room. 

 "What's that supposed to mean?! I'll have you know, I actually just saw someone else a few minutes ago, and she was was prettier than you!" Ghastly Girl exclaimed. She looks hurt, like a small child. (To continue talking to Ghastly Girl, simply type "Talk to Ghastly Girl OR g").

>x self
You look shaken and a little bit dirty.

>g
You look shaken and a little bit dirty.

>talk to ghastly girl
 "Wait, I'm sorry, I didn't mean that," you hastily apologize. "Who did you see?" 

 "Oh, what's it to you?" Ghastly Girl replies sassily. (To continue talking to Ghastly Girl, simply type "Talk to Ghastly Girl OR g").

>g
 "I lost my friend and I'm looking for her. Please, it's really important!" you beg desperately. 

 "Oh fine, I might have seen the master move a certain rug over in the Bedroom, but I don't know." (To continue talking to Ghastly Girl, simply type "Talk to Ghastly Girl OR g").

>g
 "A rug? Some help you are. Whatever." you reply.

>g
 You don't want to talk to Ghastly Girl anymore. She's irritating.

>e
The Rustic Bedroom
You walk into a bedroom that seems completely out of place in the FUNHAUS. It has red walls and a large bed with a rich brown colored oak headboard. There's a brown oak table by the bed with a vase on it and a big tapestry-like rug in the middle of the room. You can see an exit here to the west.

>x red walls
Deep burgundy walls surround you in the bedroom.

>x large bed
A big bed with lots of pillows and blankets. One of the pillows looks out of place.

>x pillow
You can't see any such thing.

>x pillow out of place
You can't see any such thing.

>x colored oak headboard
You can't see any such thing.

>x brown colored oak headboard
A large, beautiful oak headboard.

>x brown oak table
A small bedside table. A vase is here.

>take vase
Taken.

>break vase
What do you want to break Vase with?

>pepperspray
What do you want to pepperspr?

>x vase
A tall, skinny red vase.

* * *

I beg your pardon?

>x rug
The rug has very small and intricate red and gold detailing all over it. It looks like it's a little crooked, like it's been moved recently.

>move rub
You can't see any such thing.

>move rug
You move just a corner of the rug up and discover that the floor underneath it is a much darker shade of wood than anywhere else in the room. You move the rug completely out of the way revealing a trapdoor leading down!

>open trapdoor
You can't see any such thing.

>d
The Basement
A dark room with cement walls and floors. There's hardly any furniture in here except for a shelf on the west wall. There's an exit to the south.

"Oh my god, you found me! Help!" exclaims Jess. 
 
 (To talk to Jess, simply type "Talk to Jess".)

After you jump down through the trapdoor, you see Jess in the corner of the dark room tied up! The clown doesn't seem to be around right now, hurry!

>x shelf
An old shelf. The only thing on it is a rusty old knife.

>take rusty old knife
Taken.

>talk to jess
 "Jess! Are you okay?" you ask. 

 "I'm okay, we have to  get out of here! The clown left, but he'll be back soon..." she replies with fear shaking her voice. (To continue talking to Jess, simply type "Talk to Jess" OR g.)

>up
The trapdoor is closed now, and you can't reach it anyways. There's no way back up.

>g
The trapdoor is closed now, and you can't reach it anyways. There's no way back up.

>talk to jess
 "Okay, but you're tied up!" you exclaim. 

 "Yeah, I guess you  have to find something to break the rope," she says.

>command list
This is a list of commands available in the game. Any other action does not exist. Available shortcuts for commands are in parenthesis. 

Commands: North (n), East (e), South (s), West (w), up, down, Examine (x), Look (l), Inventory (i), 
Break ____ with ____ , Take ____ , Insert ____ into____, Press ____, Talk to ____, Fix____ with ____ , Pepperspray ____.

>break rope with knife
You cut through the rope binding her wrists with the knife. 

 To talk to Jess, simply type "Talk to Jess".

* * *

>talk to jess
"Oh, finally! My wrists feel so much better now, let's get out of here!" Jess exclaims.

>g
"Oh, finally! My wrists feel so much better now, let's get out of here!" Jess exclaims.

>l
The Basement
A dark room with cement walls and floors. There's hardly any furniture in here except for a shelf on the west wall. There's an exit to the south.

"Oh my god, you found me! Help!" exclaims Jess. 
 
 (To talk to Jess, simply type "Talk to Jess".)

>s
The Secret Passageway
A barren passageway with a trapdoor on the ceiling leading to the outside world.

You run into the Secret Passageway and are met with a cackle and the white-faced, red-nosed clown that has been tormenting you all night! He's blocking the only way out and up back to freedom!

* * *

>insert knife into clown
That can't contain things.

>talk to clown
You can only do that to something animate.

>pepperspray clown
You pepper spray the clown, messing up his makeup and rendering him completely useless to his cause of never letting you two leave.

>leave
But you aren't in anything at the moment.

>up
You climb up through the trapdoor and find yourself back outside! You're out of that god-awful FUNHAUS and you're never going back again. Freedom!

    *** The End ***

Would you like to RESTART, RESTORE a saved game, QUIT or UNDO the last command?

* * *

>break lock with pliers
You break the lock on the door to the FUNHAUS.

>open door
You open FUNHAUS Front Door.

>n
The Hallway
A black, ominous hallway. A faded pink door is to the west and a faded blue door is to the east.

A flash of white face paint and big red nose grab Jessica from your side. Before you know it they're gone, and all you can hear is the clown cackling and Jessica screaming as he takes her farther and farther into the house. You have to find her and escape as soon as you can.

>w
(first opening Pinkdoor)

The Ball Pit
You fall of the edge of the doorway into a pit of plastic colored balls. The walls are completely bare except for four colored indentations.

* * *

>w
The Ball Pit
You fall of the edge of the doorway into a pit of plastic colored balls. The walls are completely bare except for four colored indentations.

>x balls
Plastic colored balls of the purple, red, yellow, pink, green, and blue variety.

>x purple ball
A purple ball, purple like the shiny cheap sateen of the clown's costume.

>take purple ball
Taken.

>take balls
Which ball do you mean dummy? You can't take all of them at once. Jeez, you have to be smarter than this if you want to make it out alive.

>x indentations
There are four spherical indentations on the wall. They're colored: red, yellow, green, blue.

* * *

>e
(first opening Bluedoor)
It seems to be locked.

* * *

>comamands list
That's not a verb I recognise.

>commands list
This is a list of commands available in the game. Any other action does not exist. Available shortcuts for commands are in parenthesis. 

Commands: North (n), East (e), South (s), West (w), up, down, Examine (x), Look (l), Inventory (i), 
Break ____ with ____ , Take ____ , Insert ____ into____, Press ____, Talk to ____, Fix____ with ____ , Pepperspray ____.

>x sign
You can't see any such thing.

>x rickety old sign
You can't see any such thing.

>x red door
You can't see any such thing.

>x door
 An old, red door, with paint chipping off from years of weathering and neglect. There's a big lock on it . .

>x lock
You see nothing special about Lock.

>open door
It seems to be locked.

>break lock
What do you want to break Lock with?

>i
You are carrying:
  Pliers
  Pepper spray

>break lock with pliers
You break the lock on the door to the FUNHAUS.

* * *

>open door
You open FUNHAUS Front Door.

>go in
You can't go that way.

>go through do
You can't see any such thing.

>go through door
The Hallway
A black, ominous hallway. A faded pink door is to the west and a faded blue door is to the east.

>l
The Hallway
A black, ominous hallway. A faded pink door is to the west and a faded blue door is to the east.

>take all
There are none at all available!

>x pink door
An old pink door. The paint is fading and chipping off.

>x blue door
An old blue door. The paint is fading and chipping off.

>open pink door
You open Pinkdoor.

>open blue door
You open Bluedoor.

>n
You can't go that way.

>w
The Ball Pit
You fall off the edge of the doorway into a pit of plastic colored balls. The walls are completely bare except for four Colored Indentations with a big button next to them.

* * *

>command list
This is a list of commands available in the game. Any other action does not exist. Available shortcuts for commands are in parenthesis. 

Commands: North (n), East (e), South (s), West (w), up, down, Examine (x), Look (l), Inventory (i), 
Break ____ with ____ , Take ____ , Insert ____ into____, Press ____, Talk to ____, Fix____ with ____ , Pepperspray ____.

>n
The door is locked, obviously. The FUNHAUS has been abandoned for years. You have to break the lock.

>break with fist
You can't see any such thing.

>break door with fist
You can't see any such thing.

>i
You are carrying:
  Pliers
  Pepper spray

* * *

I beg your pardon?

>break lock with pliers
You break the lock on the door to the FUNHAUS.

* * *

>n
The Hallway
A black, ominous hallway. A faded pink door is to the west and a faded blue door is to the east.

A flash of white face paint and big red nose grab Jessica from your side. Before you know it they're gone, and all you can hear is the clown cackling and Jessica screaming as he takes her farther and farther into the house. You're all alone now. You have to find her and escape as soon as you can.

>i
You are carrying:
  Pliers
  Pepper spray

>n
You can't go that way.

>w
(first opening Pinkdoor)

The Ball Pit
You fall of the edge of the doorway into a pit of plastic colored balls. The walls are completely bare except for four colored indentations with a big button next to them.

>examine balls
Plastic colored balls of the purple, red, yellow, pink, green, and blue variety.

>take blue ball
Taken.

>take red ball
Taken.

>take yellow ball
Taken.

>take green ball
Taken.

>take pink ball
Taken.

>examine buttons
You can't see any such thing.

>examine button
A big, red button, probably meant for pressing.

>press button
Doesn't seem to do anything yet.

>e
The door slammed shut when you fell in and is locked now. You hear a cackle on the other side. Looks like you're not so alone.

>scream
That's not a verb I recognise.

>examine indentations
Which do you mean, Indentations, Red indentation, Blue indentation, Yellow indentation or Green indentation?

>commands lisst
You can't see any such thing.

>commands list
This is a list of commands available in the game. Any other action does not exist. Available shortcuts for commands are in parenthesis. 

Commands: North (n), East (e), South (s), West (w), up, down, Examine (x), Look (l), Inventory (i), 
Break ____ with ____ , Take ____ , Insert ____ into____, Press ____, Talk to ____, Fix____ with ____ , Pepperspray ____.

>insert blue ball into blue indentation
You put Blue ball into Blue indentation.

>insert red ball into red indentation
You put Red ball into Red indentation.

>insert yellow ball into yellow indentation
You put Yellow ball into Yellow indentation.

>insert green ball into green indentation
You put Green ball into Green indentation.

>press button
A big rumbling noise erupts around you. You stand in awe as the wall starts to crack. A large rectangular piece of it breaks off and falls into the room, and you barely move out of the way in time. It's a doorway to another room to the north.

* * *

>n
The Creepy Paintings
The room's walls are lined with dozens of creepy, nerve-racking paintings. There are ones of clowns, dolls, fake Mona Lisa, and even a ghastly girl standing in a dark forest. Wait, the Ghastly Girl seems to be moving! You can see an exit here to the east.

"Hey little one, why don't you come over and talk to me?" says Ghastly Girl.
 
 (To talk to Ghastly Girl, simply type "Talk to Ghastly Girl.")

>talk to ghastly girl
 "Hey," you say reluctantly. 

 "Hi there, you're new. We don't normally get a lot of visitors around here," replies Ghastly Girl. (To continue talking to Ghastly Girl, simply type "Talk to Ghastly Girl OR g").

* * *

>g
 "Yeah, well I'm not surprised about that part," you say with a sigh, looking around the dilapidated room. 

 "What's that supposed to mean?! I'll have you know, I actually just saw someone else a few minutes ago, and she was was prettier than you!" Ghastly Girl exclaimed. She looks hurt, like a small child. (To continue talking to Ghastly Girl, simply type "Talk to Ghastly Girl OR g").

>g
 "Wait, I'm sorry, I didn't mean that," you hastily apologize. "Who did you see?" 

 "Oh, what's it to you?" Ghastly Girl replies sassily. (To continue talking to Ghastly Girl, simply type "Talk to Ghastly Girl OR g").

>g
 "I lost my friend and I'm looking for her. Please, it's really important!" you beg desperately. 

 "Oh fine, I might have seen the master move a certain rug over in the Bedroom, but I don't know." (To continue talking to Ghastly Girl, simply type "Talk to Ghastly Girl OR g").

* * *

>g
 You don't want to talk to Ghastly Girl anymore. She's irritating.

>g
 You don't want to talk to Ghastly Girl anymore. She's irritating.

>ge
That's not a verb I recognise.

>e
The Rustic Bedroom
You walk into a bedroom that seems completely out of place in the FUNHAUS. It has red walls and a large bed with a rich brown colored oak headboard. There's a brown oak table by the bed with a vase on it and a big tapestry-like rug in the middle of the room. You can see an exit here to the west.

>move rug
You move just a corner of the rug up and discover that the floor underneath it is a much darker shade of wood than anywhere else in the room. You move the rug completely out of the way revealing a trapdoor leading down!

>command list
This is a list of commands available in the game. Any other action does not exist. Available shortcuts for commands are in parenthesis. 

Commands: North (n), East (e), South (s), West (w), up, down, Examine (x), Look (l), Inventory (i), 
Break ____ with ____ , Take ____ , Insert ____ into____, Press ____, Talk to ____, Fix____ with ____ , Pepperspray ____.

>dowb
That's not a verb I recognise.

>down
The Basement
A dark room with cement walls and floors. There's hardly any furniture in here except for a shelf on the west wall. There's an exit to the south.

"Oh my god, you found me! Help!" exclaims Jess. 
 
 (To talk to Jess, simply type "Talk to Jess".)

After you jump down through the trapdoor, you see Jess in the corner of the dark room tied up! The clown doesn't seem to be around right now, hurry!

>break rope with pliers
You can't break the rope with that.

>talk to jess
 "Jess! Are you okay?" you ask. 

 "I'm okay, we have to  get out of here! The clown left, but he'll be back soon..." she replies with fear shaking her voice. (To continue talking to Jess, simply type "Talk to Jess" OR g.)

* * *

>g
 "Okay, but you're tied up!" you exclaim. 

 "Yeah, I guess you  have to find something to break the rope," she says.

>up
The Rustic Bedroom
You walk into a bedroom that seems completely out of place in the FUNHAUS. It has red walls and a large bed with a rich brown colored oak headboard. There's a brown oak table by the bed with a vase on it and a big tapestry-like rug in the middle of the room. You can see an exit here to the west.

>down
The Basement
A dark room with cement walls and floors. There's hardly any furniture in here except for a shelf on the west wall. There's an exit to the south.

"Oh my god, you found me! Help!" exclaims Jess. 
 
 (To talk to Jess, simply type "Talk to Jess".)

After you jump down through the trapdoor, you see Jess in the corner of the dark room tied up! The clown doesn't seem to be around right now, hurry!

>g
You can't go that way.

>talk to jess
 "Okay, but you're tied up!" you exclaim. 

 "Yeah, I guess you  have to find something to break the rope," she says.

>break rope with pliers
You can't break the rope with that.

>break rope with vase
You can't see any such thing.

>i
You are carrying:
  Pink ball
  Pliers
  Pepper spray

>x chest
You can't see any such thing.

>x shelf
An old shelf. The only thing on it is a rusty old knife.

>x shelf
An old shelf. The only thing on it is a rusty old knife.

>x knife
You see nothing special about Knife.

>take kine]
You can't see any such thing.

>take knife
Taken.

>break ropes with knife
You can't see any such thing.

>break rope with knife
You cut through the rope binding her wrists with the knife. 

 To talk to Jess, simply type "Talk to Jess".

* * *

>talk to jess
"Oh, finally! My wrists feel so much better now, let's get out of here!" Jess exclaims.

>up
The Rustic Bedroom
You walk into a bedroom that seems completely out of place in the FUNHAUS. It has red walls and a large bed with a rich brown colored oak headboard. There's a brown oak table by the bed with a vase on it and a big tapestry-like rug in the middle of the room. You can see an exit here to the west.

* * *

>down
The Basement
A dark room with cement walls and floors. There's hardly any furniture in here except for a shelf on the west wall. There's an exit to the south.

"Oh my god, you found me! Help!" exclaims Jess. 
 
 (To talk to Jess, simply type "Talk to Jess".)

After you jump down through the trapdoor, you see Jess in the corner of the dark room tied up! The clown doesn't seem to be around right now, hurry!

>s
The Secret Passageway
A barren passageway with a trapdoor on the ceiling leading to the outside world.

You run into the Secret Passageway and are met with a cackle and the white-faced, red-nosed clown that has been tormenting you all night! He's blocking the only way out and up back to freedom!

>command list
This is a list of commands available in the game. Any other action does not exist. Available shortcuts for commands are in parenthesis. 

Commands: North (n), East (e), South (s), West (w), up, down, Examine (x), Look (l), Inventory (i), 
Break ____ with ____ , Take ____ , Insert ____ into____, Press ____, Talk to ____, Fix____ with ____ , Pepperspray ____.

>pepperspray clown
You pepper spray the clown, messing up his makeup and rendering him completely useless to his cause of never letting you two leave.

I beg your pardon?

>up
You climb up through the trapdoor and find yourself back outside! You're out of that god-awful FUNHAUS and you're never going back again. Freedom!

    *** The End ***

Would you like to RESTART, RESTORE a saved game, QUIT or UNDO the last command?

* * *

>g
 You don't want to talk to Ghastly Girl anymore. She's irritating.

>n
You can't go that way.

>s
The piece of the wall is miraculously pushed up back in line with the rest of the wall. You hear a cackle on the other side. Looks like you're not so alone.

>e
The Rustic Bedroom
You walk into a bedroom that seems completely out of place in the FUNHAUS. It has red walls and a large bed with a rich brown colored oak headboard. There's a brown oak table by the bed with a vase on it and a big tapestry-like rug in the middle of the room. You can see an exit here to the west.

>examine headboard
A large, beautiful oak headboard.

>command list
This is a list of commands available in the game. Any other action does not exist. Available shortcuts for commands are in parenthesis. 

Commands: North (n), East (e), South (s), West (w), Examine (x), Look (l), Inventory (i), 
Break ____ with ____ , Take ____ , Insert ____ into____, Press ____, Talk to ____, Fix____ with ____ , Pepperspray ____.

* * *

I beg your pardon?

>examine table
A small bedside table. A vase is here.

>examine vase
A tall, skinny red vase.

>take vase
Taken.

>examine rug
The rug has very small and intricate red and gold detailing all over it. It looks like it's a little crooked, like it's been moved recently.

>move rug
You move just a corner of the rug up and discover that the floor underneath it is a much darker shade of wood than anywhere else in the room. You move the rug completely out of the way revealing a trapdoor leading down!

>open door
You can't see any such thing.

* * *

>commands list
This is a list of commands available in the game. Any other action does not exist. Available shortcuts for commands are in parenthesis. 

Commands: North (n), East (e), South (s), West (w), Examine (x), Look (l), Inventory (i), 
Break ____ with ____ , Take ____ , Insert ____ into____, Press ____.

>break lock with pliers
You break the lock on the door to the FUNHAUS.

>w
You can't go that way.

>n
The Hallway
A black, ominous hallway. A faded pink door is to the west and a faded blue door is to the east.

A flash of white face paint and big red nose grab Jessica from your side. Before you know it they're gone, and all you can hear is the clown cackling and Jessica screaming as he takes her farther and farther into the house. You're all alone now. You have to find her and escape as soon as you can.

>w
(first opening Pinkdoor)

The Ball Pit
You fall of the edge of the doorway into a pit of plastic colored balls. The walls are completely bare except for four colored indentations with a big button next to them.

>e
The door slammed shut when you fell in and is locked now. You hear a cackle on the other side. Looks like you're not so alone.

>put red ball in red indentation
(first taking Red ball)
You put Red ball into Red indentation.

>put green ball in green indentation
(first taking Green ball)
You put Green ball into Green indentation.

* * *

>i
You are carrying:
  Pliers
  Pepper spray

* * *

>n
The door is locked, obviously. The FUNHAUS has been abandoned for years. You have to break in.

>break lock with pliers
You break the lock on the door to the FUNHAUS.

* * *

>w
(first opening Pinkdoor)

The Ball Pit
You fall of the edge of the doorway into a pit of plastic colored balls. The walls are completely bare except for four colored indentations with a big button next to them.

>press button
Doesn't seem to do anything yet.

>commands list
This is a list of commands available in the game. Any other action does not exist. Available shortcuts for commands are in parenthesis. 

Commands: North (n), East (e), South (s), West (w), Examine (x), Look (l), Inventory (i), 
Break ____ with ____ , Take ____ , Insert ____ into, Press ____.

* * *

>w
(first opening Pinkdoor)

The Ball Pit
You fall of the edge of the doorway into a pit of plastic colored balls. The walls are completely bare except for four colored indentations with a big button next to them.

>n
It's just walls. Nowhere to go.

>put red ball in red indentation
(first taking Red ball)
You put Red ball into Red indentation.

>put yellow ball in yelow indentation
You can't see any such thing.

>oops yellow
(first taking Yellow ball)
You put Yellow ball into Yellow indentation.

>put green ball in green indentation
(first taking Green ball)
You put Green ball into Green indentation.

* * *

>put blue ball in blue indentation
(first taking Blue ball)
You put Blue ball into Blue indentation.

>n
The Creepy Paintings
The room's walls are lined with dozens of creepy, nerve-racking paintings. There are ones of clowns, dolls, fake Mona Lisa, and even a ghastly girl standing in a dark forest. Wait, the Ghastly Girl seems to be moving!

"Hey little one, why don't you come over and talk to me?" says Ghastly Girl.
 
 (To talk to Ghastly Girl, simply type "Talk to Ghastly Girl.")

>press button
You can't see any such thing.

>n
You can't go that way.

>n
You can't go that way.

>undo
The Creepy Paintings
[Previous turn undone.]

>undo
The Creepy Paintings
[Previous turn undone.]

>undo
The Ball Pit
[Previous turn undone.]

* * *

>press button
Doesn't seem to do anything yet.

>n
It's just walls. Nowhere to go.

>put blue ball in blue indentation
(first taking Blue ball)
You put Blue ball into Blue indentation.

>put green ball in green indentation
(first taking Green ball)
You put Green ball into Green indentation.

>press button
A big rumbling noise erupts around you. You stand in awe as the wall starts to crack. A large rectangular piece of it breaks off and falls into the room, and you barely move out of the way in time. It's a doorway to another room to the north.

>n
The Creepy Paintings
The room's walls are lined with dozens of creepy, nerve-racking paintings. There are ones of clowns, dolls, fake Mona Lisa, and even a ghastly girl standing in a dark forest. Wait, the Ghastly Girl seems to be moving!

"Hey little one, why don't you come over and talk to me?" says Ghastly Girl.
 
 (To talk to Ghastly Girl, simply type "Talk to Ghastly Girl.")

>x ghastly girl
Her face is shrouded by her black, stringy hair. She wears a simple but old-fashioned black dress, and she stands in the middle of a dark forest where nothing seems to grow. Who was the madman who thought to paint this one?!

>g
Her face is shrouded by her black, stringy hair. She wears a simple but old-fashioned black dress, and she stands in the middle of a dark forest where nothing seems to grow. Who was the madman who thought to paint this one?!

>talk to ghastly girl
 "Hey," you say reluctantly. 

 "Hi there, you're new. We don't normally get a lot of visitors around here," replies Ghastly Girl. (To continue talking to Ghastly Girl, simply type "Talk to Ghastly Girl OR g").

* * *

>g
 You don't want to talk to Ghastly Girl anymore. She's irritating.

>s
The Ball Pit
You fall of the edge of the doorway into a pit of plastic colored balls. The walls are completely bare except for four colored indentations with a big button next to them.

>n
The Creepy Paintings
The room's walls are lined with dozens of creepy, nerve-racking paintings. There are ones of clowns, dolls, fake Mona Lisa, and even a ghastly girl standing in a dark forest. Wait, the Ghastly Girl seems to be moving!

"Hey little one, why don't you come over and talk to me?" says Ghastly Girl.
 
 (To talk to Ghastly Girl, simply type "Talk to Ghastly Girl.")

>talk to ghastly girl
 You don't want to talk to Ghastly Girl anymore. She's irritating.

* * *

>n
The door is locked, obviously. The FUNHAUS has been abandoned for years. You have to break in.

>i
You are carrying:
  Pliers
  Pepper spray

>i
You are carrying:
  Pliers
  Pepper spray

>break lock with pliers
You break the lock on the door to the FUNHAUS. You're in.

>n
(first opening FUNHAUS Front Door)

The Hallway

>commands
What do you want to commands?

>commands list
This is a list of commands available in the game. Any other action does not exist. Available shortcuts for commands are in parenthesis. 

Commands: North (n), East (e), South (s), West (w), Examine (x), Look (l), Inventory (i), 
Break ____ with ____ , Take ____ .

>x door
. The other side of the red door. Your only way out and back to freedom .

>s
The Fairgrounds
It's dark out, and all you can see is the faint outline of a red door with a rickety old sign on top of it. It says FUNHAUS.

>x door
 An old, red door, with paint chipping off from years of weathering and neglect. There's a big lock on it . .

* * *

>n
The door is locked, obviously. The FUNHAUS has been abandoned for years. You have to break in.

>n
The door is locked, obviously. The FUNHAUS has been abandoned for years. You have to break in.

>commands list
This is a list of commands available in the game. Any other action does not exist. Available shortcuts for commands are in parenthesis. 

Commands: North (n), East (e), South (s), West (w), Examine (x), Look (l), Inventory (i), 
Break ____ with ____ , Take ____ , Put ____ in

>break lock with pliers
You break the lock on the door to the FUNHAUS.

* * *

>n
The Hallway
A black, ominous hallway. A faded pink door is to the west and a faded blue door is to the east.

A flash of white face paint and big red nose grab Jessica from your side. Before you know it they're gone, and all you can hear is the clown cackling and Jessica screaming as he takes her farther and farther into the house. You're all alone now. You have to find her and escape as soon as you can.

>w
(first opening Pinkdoor)

The Ball Pit
You fall of the edge of the doorway into a pit of plastic colored balls. The walls are completely bare except for four colored indentations.

>e
The door slammed shut when you fell in and is locked now. You hear a cackle on the other side. Looks like you're not so alone.

>e
The door slammed shut when you fell in and is locked now. You hear a cackle on the other side. Looks like you're not so alone.

>take red ball
Taken.

* * *

>take green ball
Taken.

* * *

>e
The door slammed shut when you fell in and is locked now. You hear a cackle on the other side. Looks like you're not so alone.

* * *

>show verb push
You can't see any such thing.

>showverb push
Verb 'clear' 'move' 'push' 'shift' 
     * noun -> Push
     * noun noun=Routine(346431) -> PushDir
     * noun 'to' noun=Routine(346468) -> PushDir

>showverb unlcok
Try typing "showverb" and then the name of a verb.

>showverb unlock
Verb 'unlock' 
     * noun 'with' held -> Unlock

>break lock with pliers
You break the lock on the door to the FUNHAUS.

* * *

>w
(first opening Pinkdoor)

The Ball Pit
You fall of the edge of the doorway into a pit of plastic colored balls. The walls are completely bare except for four colored indentations with a big button next to them.

>put red ball in red indentation
(first taking Red ball)
You put Red ball into Red indentation.

>put yellow ball in yellow indentation
(first taking Yellow ball)
You put Yellow ball into Yellow indentation.

>put green ball in green indentation
(first taking Green ball)
You put Green ball into Green indentation.

* * *

>n
The Creepy Paintings
The room's walls are lined with dozens of creepy, nerve-racking paintings. There are ones of clowns, dolls, fake Mona Lisa, and even a ghastly girl standing in a dark forest. Wait, the Ghastly Girl seems to be moving!

"Hey little one, why don't you come over and talk to me?" says Ghastly Girl.
 
 (To talk to Ghastly Girl, simply type "Talk to Ghastly Girl.")

>e
The Rustic Bedroom
You walk into a bedroom that seems completely out of place in the FUNHAUS. It has red walls and a large bed with a rich brown colored oak headboard. There's a brown oak table by the bed with a vase on it and a big tapestry-like rug in the middle of the room.

>x rug
The rug has very small and intricate red and gold detailing all over it. It looks like it's a little crooked, like it's been moved recently.

>down
There's no way to go down right now.

>move rug
You move just a corner of the rug up and discover that the floor underneath it is a much darker shade of wood than anywhere else in the room. You move the rug completely out of the way revealing a trapdoor!

* * *

>down
The Basement

>take all
There are none at all available!

>up
The Rustic Bedroom
You walk into a bedroom that seems completely out of place in the FUNHAUS. It has red walls and a large bed with a rich brown colored oak headboard. There's a brown oak table by the bed with a vase on it and a big tapestry-like rug in the middle of the room.

>take all
There are none at all available!

* * *

>x doir
You can't see any such thing.

>x door
 An old, red door, with paint chipping off from years of weathering and neglect. There's a big lock on it . .

>break lock with pliers
You break the lock on the door to the FUNHAUS.

* * *

>n
The Hallway
A black, ominous hallway. A faded pink door is to the west and a faded blue door is to the east.

A flash of white face paint and big red nose grab Jessica from your side. Before you know it they're gone, and all you can hear is the clown cackling and Jessica screaming as he takes her farther and farther into the house. You're all alone now. You have to find her and escape as soon as you can.

>e
(first opening Bluedoor)

The Mirrors
You walk into the room and the walls are lined with funky, light-bending mirrors. Obviously, they haven't seen the light in years. They're completely covered in dust and grime. You can see an exit here to the north.

>s
You can't go that way.

>n
The Arcade
The walls are dingy and old. There's a ping pong table in the northeast corner, some sort of Gorilla Game in the southeast corner, and a Whac-a-Mole game on the west wall.

>x table
You can't see any such thing.

>x ping pong table
An old ping pong table. The actual table part is an off-white color, aged from the years of neglect. There's the normal stuff a ping pong table has, two paddles, a ball, and one of those ball holder things.

>take paddle
Taken.

>take ball
Taken.

>take ping pong paddle
You already have that.

>take holder
You can't see any such thing.

>take table
You can't see any such thing.

>x game
You can't see any such thing.

>x gorrila
You can't see any such thing.

>x gorrila game
You can't see any such thing.

>x gorilla
He wants his banana.

>x mole
You can't see any such thing.

>x whac-a-mole
An old Whac-a-Mole game. It seems to be placed in an odd area, covering a part of the wall. It looks like it's broken and missing a few parts. It must need to be fixed.

>move whac-a-mole
It is fixed in place.

>put ball in whac-a-mole
That can't contain things.

>put paddle in whac-a-mole
That can't contain things.

>command list
This is a list of commands available in the game. Any other action does not exist. Available shortcuts for commands are in parenthesis. 

Commands: North (n), East (e), South (s), West (w), up, down, Examine (x), Look (l), Inventory (i), 
Break ____ with ____ , Take ____ , Insert ____ into____, Press ____, Talk to ____, Fix____ with ____ , Pepperspray ____.

>fix whac-a-mole with paddle
That's hardly the right tool to fix this with.

>fix whac-a-mole with ball
That's hardly the right tool to fix this with.

>x gorilla game
It's some sort of pinball game where you have to get the banana to the gorilla. Interesting.

>x mole
You can't see any such thing.

>x banana
The gorilla wants it, I guess.

>give banana to gorilla
You can only do that to something animate.

>i
You are carrying:
  pingpongball
  Paddles
  Pliers
  Pepper spray

>x whac-a-mole
An old Whac-a-Mole game. It seems to be placed in an odd area, covering a part of the wall. It looks like it's broken and missing a few parts. It must need to be fixed.

>x wall
You can't see any such thing.

>x ping pong table
An old ping pong table. The actual table part is an off-white color, aged from the years of neglect. There's the normal stuff a ping pong table has, two paddles, a ball, and one of those ball holder things.

>i
You are carrying:
  pingpongball
  Paddles
  Pliers
  Pepper spray

>take ball holder
Taken.

>x paddles
Your standard red ping pong paddles.

>x ball
Just a white ping pong ball. Looks un-bouncy.

>x ball holder
A built in holder for ping pong balls. Looks like there's something shiny in here...

In Ballholder is Wrench.

>take wrench
Taken.

* * *

I beg your pardon?

>fix whac-a-mole with wrench
The Whac-a-Mole machine whirs to life and goes crazy! The moles are popping up and down out of their little holes. Finally, the whole machine slides to the right revealing an exit to the west.

>w
The Rustic Bedroom
You walk into a bedroom that seems completely out of place in the FUNHAUS. It has red walls and a large bed with a rich brown colored oak headboard. There's a brown oak table by the bed with a vase on it and a big tapestry-like rug in the middle of the room. You can see an exit here to the west.

>break wrench
What do you want to break Wrench with?